Voxel Editor CLI v1.0
====================

Initializing Voxel Editor...
Running in headless mode (no rendering)
Camera set to view workspace center at (2.5, 2.5, 2.5)
Initialization complete!
Type 'help' for available commands.

> Voxel Editor CLI - Available Commands
=====================================

Edit Operations:
  redo                 - Redo last undone operation
  workspace            - Set workspace dimensions
  undo                 - Undo last operation
  fill                 - Fill a box region with voxels (coordinates must include units: cm or m)
  delete               - Delete a voxel at position (coordinates must include units: cm or m)
  resolution           - Set voxel resolution
  place                - Place a voxel at position (coordinates must include units: cm or m)

File Operations:
  saveas               - Save the project with a new name
  open                 - Open a project file
  save                 - Save the current project
  new                  - Create a new project
  export               - Export to STL format

Group Management:
  show                 - Show a group
  hide                 - Hide a group
  groups               - List all groups
  group                - Create group from selection

Help & Info:
  help                 - Show available commands or command help

Selection:
  selectnone           - Clear selection
  selectbox            - Select voxels in box region (coordinates must include units: cm or m)
  select               - Select voxels at position
  selectall            - Select all voxels

System:
  build                - Show build information
  validate             - Validate the rendering pipeline and diagnose issues
  sleep                - Pause execution for specified seconds
  debug                - Debug commands for troubleshooting
  status               - Show editor status
  quit                 - Exit the application
  clear                - Clear the screen

View Controls:
  edges                - Toggle edge/wireframe overlay rendering
  shader               - Switch between shader modes or list available shaders
  screenshot           - Take a screenshot of the current view
  rotate               - Rotate camera
  zoom                 - Zoom camera in/out
  camera               - Set camera view preset
  camera-info          - Show current camera information
  center               - Center camera on origin or voxels
  grid                 - Toggle ground plane grid visibility
  resetview            - Reset camera to default view

Type 'help <command>' for detailed command help.

> Goodbye!

Shutting down...
